1111111111111111111111111111111111
1E000000000C000C00000C000D00000011
1010010100100C00101001000000010111
1010010010101010001001000000010111
1P0000000C0000000000000000000000C1
1111111111111111111111111111111111
